x________________
|
|
|......1..1......
|.....1....1.....
|
|.....1....1.....
|.....1....1.....
|
|.....1....1.....
|......1..1......
|
|
|
|