x________________
|
|
|
|.......11.......
|......1221......
|.....123321.....
|......1221......
|.......11.......
|
|
|
|
|
|