x_ _ _ _ _ _ _ _ _ _ _ _ _ _ _ _
|
|
|. . . . . 2 1 . . 1 1 . . . . .
|. . . . . 1 1 . . 3 1 . . . . .
|
|. . . . . 3 1 . . 2 1 . . . . .
|. . . . . 1 1 . . 1 1 . . . . .
|
|. . . . . 1 2 . . 1 1 . . . . .
|. . . . . 1 1 . . 1 1 . . . . .
|
|
|
|