x________________
|
|
|.....21..11.....
|.....11..31.....
|
|.....31..21.....
|.....11..11.....
|
|.....12..11.....
|.....11..11.....
|
|
|
|