x_ _ _ _ _ _ _ _ _ _ _ _ _ _ _ _
|
|
|. . . . . 3 . 3 3 . 3 . . . . .
|. . . . . 2 . 3 3 . 3 . . . . .
|. . . . . 3 . . . . 3 . . . . .
|
|
|. . . . . 3 . . . . 1 . . . . .
|. . . . . 1 . 3 3 . 3 . . . . .
|. . . . . 1 . 2 2 . 2 . . . . .
|
|
|
|