x_ _ _ _ _ _ _ _ _ _ _ _ _ _ _ _
|
|
|. . . . . . 3 3 3 3 . . . . . .
|
|. . . . . 3 3 . . 3 3 . . . . .
|. . . . . 3 . . . . 3 . . . . .
|. . . . . 3 . . . . 3 . . . . .
|. . . . . 3 3 . . 3 3 . . . . .
|
|. . . . . . 3 2 2 0 . . . . . .
|
|
|
|