x________________
|
|
|......3333......
|
|.....33..33.....
|.....3....3.....
|.....3....3.....
|.....33..33.....
|
|......3220......
|
|
|
|